    #             #     
    #         ----+---- 
 ---+---      |.......| 
 |.....|      |.......| 
 |.....+######+.......| 
#+.....|      |.......| 
 |.....|      |.......+#
 --+----      |.......| 
   #          ---+----- 
   #             #      
   #             #      
  -+-----      --+----  
  |.....|      |.....|  
##+.....|      |.....|  
  |.....+######+.....|  
  |.....|      |.....|  
  --+----      ----+--  
    #              #    
